se acercó hasta tocar su rodilla con la mía she got closer until her knee touched mine

acostarse por la noche y levantarse en la mañana	go to bed at night and get up in the morning

aprender y enseñar	to teach and to learn
aprendo cada día un poco más	i learn each day a little more

por favor, apúrese	please hurry up
no me apures, que quiero caminar con tranquilidad	don't rush me, I want to walk slowly
se apuró para llegar a la cita a tiempo	he hurried to arrive at the appointment on time

el lavabo está atascado	the sink is clogged

La niña baja a la calle The girl went down to the street

busqué mis llaves por todas partes	i looked for my keys everywhere

camino despacio	walk slowly

cepillarse los dientes	to brush your teeth

no lo conozco	I don't know him

él cruzó el camino	he crossed the road

dar vuelta a la izqierda	turn left

dígame si duele	tell me if it hurts

dejar una propina	leave a tip

despertar y entonces, levantarse	to wake and after, to get up

me echó de la casa y me fui	she threw me out of the house and i left

cuando puede empezar	when can you start
empieza de pensar	starts thinking
te puedo conseguir su número	I can get you her number

mi padre me enseñó a pescar	my father taught me to fish

no entendí, por supuesto, nada, ni una palabra	i didn't understand, of course, nothing ..

se enteró a través de un amigo	he found out about it through a friend

Esperamos que cocines bien	we hope you cook [subj] well

me falta una persona con quien me pueda comunicar	i don't have a person with whom I can communicate

Tienes que girar la llave de manera suave	you must turn the key smoothly

los había leído todos, sin comprender mucho	I've read all of them, without understanding much
había sido	(he) used to be [sido is pp of ser]
había una vez	once upon a time
si yo hubiera sabido que habría venido if i'd known i would have come

hablo un poco de español	I speak a little Spanish

hace viento	it's windy
hacer la cama	to make the bed
haga la conexión	make the connection
haré lo que sea necesario   i will do whatever is needed
a la vez que hacía la broma, sonría as he was telling the joke, he laughed

ya casi es hora de irnos a la escuela	it's almost time to go to school
yo iba en mi bicicleta	i was riding my bike
vamos a dar un paseo	go for a walk
van en camino	they are on their way
vamos de viaje	they are going on a trip
a veces	sometimes

leer y escribir	to read and to write

el oriente es donde el sol se levanta	the east is where the sun rises

llegaré al fondo de esta cuestión	I'll get to the bottom of this question
pronto llegan tus abuelos de Cuba	soon your grandparents arrive from Cuba

ellos no llevan los zapatos	they don't wear shoes

lograr buenos resultados	to achieve good results

miraba distraída a las estrellas	i gazed absent-mindedly at the stars
Miró hacia atrás	he looked backward

Mover el cursor hacia adelante	move the cursor forward

el miedo a lo que pudiera ocurrir	the fear of what could happen
a pesar de sus deseos, no pueden obtenerlo	in spite of their wishes, they can't have it

podemos esperar una pronta respuesta	we can expect a quick response
podría decirme donde está ..    could you tell me where is ..
por favor, podría usted darme una cerveza   please, could you give me a beer

yo puse los libros en mi mochila	I put the books in my backpack

no nos queda tiempo	we don't have time
la piel quedaba tensa como cuero	the skin was stretched tight like leather

no pudo reconocer quién era	i could not recognize who it was
puede hablar mas despacio	could you speak more slowly
puede repetirlo por favor	please repeat that

me puse unos guantes para agarrar la escudilla caliente	I put on some gloves to grab the hot bowl

Yo quiero que tú limpies el baño	I would like that you would .. [pres subj]
quiere probar algo diferente	want to try something different

regresó a su casa	he returned to his house

reírse a carcajadas	laugh out load
Se rieron de ella por detrás	they laughed at her behind her back

sacó un bolígrafo de su bolso y firmó el cheque	she took a pen ..

siga derecho por esta calle	keep going straight on this street
sigue trabajando	keep working

Siéntese derecho	sit upright [straight]
síentese por favor	sit down, please

qué tengo que hacer	what should I do
si tuviera un perro lo cuidaría bien	if i had a dog..
no tengo a nadie	i don't have anyone
tengo una cita a las diez	i have an appointment at 10

tomar el tren	to take the train
tomar un trago	take a drink [alcoholic]
tomó un sorbo de agua	he took a sip of water

nos trae la cuenta, por favor	bring us the check, please

utilizamos un rodillo para pintar las paredes	we use a roller to paint the walls
usar un traje	wear a suit

veo a Juan pero no veo su carro    I see Juan but I don't see his car
no veo a nadie	i don't see anyone
ver es creer	seeing is believing

no siempre vestía ropa de mujer	he doesn't always where women's clothing